XXXXXXXXXXXXXXXXXXXXXXXXXXXXXXXXXXXXXXXXXXXXXXXXXXXXXXXXXXXXXXXXXXXXX
XXXXXXXXXXXXXXXXXXXXXXXXXXXXXXXXXXXXXXXXXXXXXXXXXXXXXXXXXXXXXXXXXXXXX
XXXXXXXXXXXXXS   XXXX  XXXXXXXX       XX  XXXXX  X        XXXXXXXXXXX
XXXXXXXXXXXXXX  XXXXX  XXXXXXX  XXXXX  X  XXXXX  X  XXXXXXXXXXXXXXXXX
XXXXXXXXXXXXXX  XXXXX  XXXXXXX  XXXXX  X  XXXXX  X  XXXXXXXXXXXXXXXXX
XXXXXXXXXXXXXX  XXXXX  XXXXXXX  XXXXX     XXXXX         XXXXXXXXXXXXX
XXXXXXXXXXXXXX  XXXXX  XXXXXXX  XXXXX  XX  XXX  XX  XXXXXXXXXXXXXXXXX
XXXXXXXXXXXXXX  XXXXX  XXXXXXX  XXXXX  XXX  X  XXX  XXXXXXXXXXXXXXXXX
XXXXXXXXXXXXX    XXXX        XX       XXXXX   XXXX        XXXXXXXXXXX
XXXXXXXXXXXXX XXXXXXXXXXXXXXXXXXX XXXXXXXXXXXXXXXX XXXXXXXXXXXXXXXXXX
XXXXXXXXXXXXX XXXXXXXXXXXXXXXXXXX XXXXXXXXXXXXXXXX XXXXXXXXXXXXXXXXXX
XXXXXXX        XX  XXXX           X  XXXXX  XX       XX  XXXX  XXXXXX
XXXXXXX  XXXXX      XX  XXXXX  XXXX  XXXXX  X  XXXXX  X   XXX  XXXXXX
XXXXXXX  XXXXX  XXX    XXXXXX  XXXX  XXXXX  X  XXXXX  X    XX  XXXXXX
XXXXXXX        XXXXX  XXXXXXX  XXXX         X  XXXXX  X  X  X  XXXXXX
XXXXXXX  XXXXXXXXXXX  XXXXXXX  XXXX  XXXXX  X  XXXXX  X  XX    XXXXXX
XXXXXXX  XXXXXXXXXXX  XXXXXXX  XXXX  XXXXX     XXXXX     XXX   XXXXXX
XXXXXXX  XXXXXXXXXXX  XXXXXXX  XXXX  XXXXX  XX       XX  XXXX EXXXXXX
XXXXXXXXXXXXXXXXXXXXXXXXXXXXXXXXXXXXXXXXXXXXXXXXXXXXXXXXXXXXXXXXXXXXX
XXXXXXXXXXXXXXXXXXXXXXXXXXXXXXXXXXXXXXXXXXXXXXXXXXXXXXXXXXXXXXXXXXXXX
