XXXXXXXXXXXXXXXXXXXXXXXXXXXXXXXXXXXXXXXXXXXXXXXXXXXXXXXXXX
XXXXXXXS   XXXX  XXXXXXXX       XX  XXXXX  X        XXXXXX
XXXXXXXX  XXXXX  XXXXXXX  XXXXX  X  XXXXX  X  XXXXXXXXXXXX
XXXXXXXX  XXXXX  XXXXXXX  XXXXX  X  XXXXX  X  XXXXXXXXXXXX
XXXXXXXX  XXXXX  XXXXXXX  XXXXX     XXXXX         XXXXXXXX
XXXXXXXX  XXXXX  XXXXXXX  XXXXX  XX  XXX  XX  XXXXXXXXXXXX
XXXXXXXX  XXXXX  XXXXXXX  XXXXX  XXX  X  XXX  XXXXXXXXXXXX
XXXXXXX    XXXX        XX       XXXXX   XXXX        XXXXXX
XXXXXXX XXXXXXXXXXXXXXXXXXX XXXXXXXXXXXXXXXX XXXXXXXXXXXXX
XXXXXXX XXXXXXXXXXXXXXXXXXX XXXXXXXXXXXXXXXX XXXXXXXXXXXXX
X        XX  XXXX           X  XXXXX  XX       XX  XXXX  X
X  XXXXX      XX  XXXXX  XXXX  XXXXX  X  XXXXX  X   XXX  X
X  XXXXX  XXX    XXXXXX  XXXX  XXXXX  X  XXXXX  X    XX  X
X        XXXXX  XXXXXXX  XXXX         X  XXXXX  X  X  X  X
X  XXXXXXXXXXX  XXXXXXX  XXXX  XXXXX  X  XXXXX  X  XX    X
X  XXXXXXXXXXX  XXXXXXX  XXXX  XXXXX     XXXXX     XXX   X
X  XXXXXXXXXXX  XXXXXXX  XXXX  XXXXX  XX       XX  XXXX EX
XXXXXXXXXXXXXXXXXXXXXXXXXXXXXXXXXXXXXXXXXXXXXXXXXXXXXXXXXX
