xxxxxxxxxxxxxxxxxxxxxxxxxxxx
xSx x xx x x xx x x xx x x x
x   x      x xx   x      x x
xxx x xxxx x xxxx x xxxx x x
x     xx            xx     x
xxxxxxxxxxxxxxxxxxx xxxx xxx
x x x xx x x xx x x xx x x x
x   x      x      x xx   x x
xxx x xxxx x xxxx x xxxx x x
x     xx     xx     xx     x
xxx xxxxxxxxxxx xxxxxxxxxxxx
x x x xx x x xx x x xx x x x
x   x      x xx   x      x x
xxx x xxxx x xxxx x xxxx x x
x     xx            xx   E x
xxxxxxxxxxxxxxxxxxxxxxxxxxxx
